##############
#      2     #
#  2         #
#      X     #
#  B     2   #
##############
